NO Textures/image.png
SO Textures/image.png
WE Textures/image.png

      
F 255,255,255
         EA              Textures/image .png                                                  
 C         225   ,30,0

        111111111111111111111111
        1111111111111111111111111
        1111111111111111111111111
        111111111111111111111111
11111111111111111111111N111111111
11111111111111111111111111111111
11111111111111111111111111111
11111111111111111111111111111
1111111111111111111111111111
11111111111111111111111111111
11111111111111111111111111111
1111111111111111 1111111111111
111111111111111 11111111111
11111111 11111 111111111111
